-------------------------
-                       -
- ; :                   -
-                       -
------------------      -
-                       -
-                       -
-                     ---
-                   -----
-     ---***----***------
-     -------------------
---          L          -
---     o       o       -
-------------------     -
-                       -
-   @@@     &&&         -
-   ---     ---      ----
-                    ----
-                    ----
----&&&-----@@@----------