-------------------------
-                       -
-                       -
-            --     : ; -
-                       -
-         --****---------
-         ---------------
---                     -
-                       -
-                       -
-    ----               -
-                       -
-                       -
-                       -
---********------       -
-----------------       -
-                       -
-                    ----
-                    ----
-----@@@----&&&----------